{
    "nombre": "Arcade",
    "dificultad": "hard",
    "config": {
        "gridSize": 40,
        "neonColor": "#00fff7"
    },
    "mapa": [
        [1,1,1,1,1,1,1,1,1,1,1,1,1,1,1,1],
        [1,0,0,0,1,0,0,0,0,0,0,1,0,0,1,1],
        [1,0,0,0,0,0,0,1,0,0,0,0,0,0,1,1],
        [1,1,1,1,1,1,1,1,1,1,1,1,1,0,1,1],
        [1,1,1,1,1,1,1,1,1,1,0,0,0,0,1,1],
        [1,0,0,0,0,0,0,0,0,1,0,1,0,0,0,1],
        [1,0,1,1,1,1,1,1,0,1,0,1,0,1,0,1],
        [1,0,1,1,1,0,0,0,0,1,0,1,0,1,0,1],
        [1,0,1,1,1,0,1,1,0,1,0,1,0,1,0,1],
        [1,0,1,0,0,0,1,1,0,1,0,1,0,1,0,1],
        [1,0,1,0,0,0,0,0,0,0,0,1,0,1,0,1],
        [1,0,1,1,1,1,1,1,1,1,1,1,0,1,0,1],
        [1,0,1,0,0,0,0,0,0,0,0,0,0,1,0,1],
        [1,0,1,1,1,1,1,1,1,1,1,1,1,1,0,1],
        [1,0,1,0,0,0,0,0,0,0,0,0,0,0,0,1],
        [1,0,1,1,1,1,1,1,1,1,1,1,1,1,1,1],
        [1,0,0,0,0,0,1,1,1,0,0,0,0,0,0,1],
        [1,1,1,1,1,0,0,0,0,0,1,1,1,1,0,1],
        [1,1,1,1,1,1,0,0,0,0,1,1,1,1,0,1],
        [1,1,1,1,1,1,1,1,1,1,1,1,1,1,0,1],
        [1,0,0,0,0,1,1,1,1,1,1,0,0,0,0,1],
        [1,0,1,1,0,0,0,0,0,0,0,0,1,1,1,1],
        [1,0,1,1,1,1,1,1,1,1,1,1,1,1,1,1],
        [1,0,0,0,0,0,0,0,0,0,1,1,1,1,1,1],
        [1,1,1,1,1,1,1,1,0,0,0,1,1,1,1,1],
        [1,1,1,1,1,1,1,1,0,1,0,1,1,1,1,1],
        [1,0,0,0,0,0,0,0,0,1,0,1,1,1,1,1],
        [1,0,1,1,1,1,1,0,1,1,0,0,0,0,0,1],
        [1,0,0,0,0,0,1,0,1,1,1,1,1,1,0,1],
        [1,1,1,1,1,0,1,0,1,1,1,1,1,0,0,1],
        [1,1,1,1,0,0,1,0,1,0,0,0,0,0,1,1],
        [1,0,0,0,0,1,1,0,1,0,1,1,1,1,1,1],
        [1,0,1,1,1,1,1,0,1,1,1,1,1,1,1,1],
        [1,0,0,0,0,0,0,0,1,1,1,1,0,0,0,1],
        [1,1,0,1,1,1,1,0,0,0,0,0,0,1,0,1],
        [1,1,0,1,1,1,1,1,1,1,1,1,1,1,0,1],
        [1,1,0,0,0,0,0,1,1,0,0,0,0,0,0,1],
        [1,1,1,1,1,1,0,0,0,0,0,1,1,1,1,1],
        [1,1,1,1,1,1,0,1,3,1,0,1,1,1,1,1],
        [1,1,1,1,1,1,1,1,1,1,1,1,1,1,1,1]
    ],
    "zombies": [
        { "x": 12, "y": 3 },
        { "x": 3, "y": 12 },
        { "x": 9, "y": 18 }
    ]
}