{
    "nombre": "Zona de tutorial",
    "config": {
        "gridSize": 40,
        "neonColor": "#00fff7"
    },
    "mapa": [
        [1,1,1,1,1,1,1,1,1,1,1,1,1,1,1,1],
        [1,3,0,0,0,0,0,0,0,0,0,0,0,0,0,1],
        [1,1,1,1,1,1,1,1,1,1,1,1,1,1,0,1],
        [1,0,0,0,0,0,0,0,0,0,0,0,2,1,0,1],
        [1,0,1,0,1,1,1,1,1,1,1,1,0,1,0,1],
        [1,0,1,0,0,0,0,0,0,0,0,0,0,0,0,1],
        [1,1,1,1,1,1,1,1,1,1,1,1,1,1,1,1]
    ],
    "zombies": [
        { "x": 12, "y": 3 }
    ]
}