{
    "nombre": "Dos caminos-dos",
    "config": {
        "gridSize": 40,
        "neonColor": "#00fff7"
    },
    "mapa": [
        [1,1,1,1,1,1,1,1,1,1,1,1,1,1,1,1,1,1,1,1],
        [1,3,0,0,0,0,0,0,0,0,0,0,0,0,0,0,0,0,0,1],
        [1,1,1,1,1,1,1,1,1,1,1,1,1,1,1,1,1,1,0,1],
        [1,0,0,0,0,0,0,0,0,0,0,0,0,0,0,0,0,0,0,1],
        [1,0,1,1,1,1,1,1,1,1,1,1,1,1,1,1,1,1,1,1],
        [1,0,1,0,0,0,0,0,0,0,1,0,0,0,0,0,0,0,0,1],
        [1,0,1,0,0,0,0,0,1,0,1,0,1,1,1,1,1,1,0,1],
        [1,0,1,1,1,1,1,0,1,0,1,0,1,0,0,0,0,0,0,1],
        [1,0,1,0,0,0,0,0,1,0,1,0,1,0,1,1,1,1,1,1],
        [1,0,1,0,1,1,1,1,1,0,1,0,1,0,0,0,0,0,0,1],
        [1,0,1,0,1,0,0,0,1,0,1,0,1,1,1,1,1,1,0,1],
        [1,0,1,0,1,0,1,0,1,0,1,0,1,0,0,0,0,0,0,1],
        [1,0,1,0,1,0,1,0,1,0,1,0,1,0,1,1,1,1,1,1],
        [1,0,1,0,1,0,1,0,1,0,0,0,0,0,0,0,1,1,1,1],
        [1,0,1,0,1,0,1,0,1,0,1,0,1,1,0,0,0,0,1,1],
        [1,0,1,0,1,0,1,0,0,0,1,0,1,0,0,1,1,0,1,1],
        [1,0,1,0,1,0,1,1,1,1,1,0,1,0,0,0,0,0,0,1],
        [1,0,1,0,1,0,1,0,0,0,0,0,1,1,1,1,1,1,0,1],
        [1,0,1,0,1,0,1,0,0,0,1,1,1,0,0,0,0,0,0,1],
        [1,0,1,0,1,0,1,0,1,1,1,0,0,0,1,1,1,1,1,1],
        [1,0,1,0,1,0,0,0,1,0,0,0,1,1,1,2,0,0,1,1],
        [1,0,1,0,1,1,1,1,1,0,1,1,0,1,1,1,1,0,1,1],
        [1,0,1,0,0,0,0,1,1,0,1,1,0,0,0,0,1,0,1,1],
        [1,0,1,1,1,1,0,1,1,0,1,1,1,1,1,0,1,0,1,1],
        [1,0,0,0,0,0,0,1,1,0,0,0,0,0,0,0,0,0,1,1],
        [1,1,1,1,1,1,1,1,1,1,1,1,1,1,1,1,1,1,1,1]
    ]
}